Room no,Block id,Capacity,Vacancy,,,,,,
1,1,3,3,,,,,,
2,1,3,3,,,,,,
3,1,3,3,,,,,,
4,1,3,3,,,,,,
5,1,4,4,,,,,,
6,1,4,4,,,,,,
7,1,4,4,,,,,,
8,2,5,5,,,,,,
9,2,5,5,,,,,,
10,2,5,5,,,,,,
11,2,3,3,,,,,,
12,2,3,3,,,,,,
13,2,3,3,,,,,,
14,2,3,3,,,,,,
15,2,4,4,,,,,,
16,2,4,4,,,,,,
17,2,4,4,,,,,,
18,3,4,4,,,,,,
19,3,4,4,,,,,,
20,3,4,4,,,,,,
21,3,5,5,,,,,,
22,3,5,5,,,,,,
23,3,5,5,,,,,,
24,3,5,5,,,,,,
25,3,5,5,,,,,,
26,3,5,5,,,,,,
